NO ./path_to_the_north_texture
SO ./path_to_the_south_texture
WE ./path_to_the_west_texture
EA ./path_to_the_east_texture

F 220,100,0
C 225,30,0

   1111111  11111111111  1111
   1000001  11100000001  1001
   1011001  11100000001111011
   1001001  11000000000000011111111
   11111111111000001110000000000001
  111000000000110000011101111111111
11100111111111011100000010001
11110111111111011101010010001
11000000110101011100000010001
10000000000000001100000010001
10000000000000001101010010001
11000001110101011111011110N01
11110111 1110101 101111010001
11111111 1111111 111111111111
