NO ./asset/textures/wall_n.xpm
EA ./asset/textures/wall_e.xpm
SO ./asset/textures/wall_s.xpm
WE ./asset/textures/wall_w.xpm

F 255,0,0
C 0,255,0



        1111111111       11111111111111111111111111111111111111111
        1000000001       10000000000000000000000000000000000000001
        1000000001       10000000000000000000000000000000000000001
        1000000001       10000000011111111111111111111111110000001
        1000000001       1000000001                       10000001
        1000000001       1000000001                       10000001
        1000000001       1000000001                       10000001
        1000000001       1000000001                       10000001
        1000000001       1000000001                       10000001
        1000000001       10000000011111111111111111       10000001
        1000000001       10000000000000000000000001       10000001
        1000000001       10000000000000000000000001       10000001
        1000000001       10000000000000000000000001       10000001
        1000000001       11111111111111111111111111       10000001
        1000000001                                        10000001
        1000000001                                        10000001
        1000000001111111111111111111111111111111111111111110000001
        1000000000000000000000000000000000000000000000000000000001
        1000000000000000000000000000000000000000000000000000000001
        100000000000000000000000000000N000000000000000000000000001
        1111111111111111111111111111111111111111111111111111111111
