NO ./asset/textures/wall_n.xpm
SO ./asset/textures/wall_s.xpm
WE ./asset/textures/wall_w.xpm
EA ./asset/textures/wall_e.xpm

F 255,0,0
C 0,255,0

11111111
10011001
10010001
1000N001
11111111
